****************************
****************************
****************************
**************<-----i*******
********************|*******
********************|*******
********************|*******
^^^^^^^^^^^^^^^#****|*******
+++++++++++++++)****|*******
+++++++++++++++]----X-------
____;++++++++++)****|*******
****(++++++++++)****|*******
****%__________$****|*******
********************|*******
****************F---X-------
****************|***v*******
****************|***********
***********F----J***********
***********|****************
***********|*<-->***********