@---------------------------#
|.ab.abo.ab.abqQ..ab.....abH|
|.cd.cdabcd.cd.ab.cd.ab..cd.|
|ab.H..cd..ab..cd....cd.....|
|cd........cd.....ab........|
|..ab..o......o...cd....S...|
|..cd.......................|
}-----#.....................|
|GGGGGv/....................|
|12ES.......................|
|34.........................|
|GGGGG^/....................|
}-----$....abab.............|
|qQo....ab.cdcd.....S.......|
|abqQab.cd.ab.o.............|
|cd.ocd....cd.......abab....|
|ab.................cdcd..H.|
|cdababqQ..........ab..abab.|
|qQcdcdqQ..........cd..cdcd.|
%---------------------------$