*****(+++++++++)*********(++
*****(+++++++++)*********%__
*****%___;+++++]----#*******
*********(+++++)****|*******
***@^^^#*%_____$****|*******
***(+++)************|*******
***(+++)***@^#****<-X--->***
***%___$***(+)******|*******
***********%_$******|*******
********************|*******
********************|*******
^^^^^^^^^^^^#*******|*******
_________;++)*******|*******
*********(++)*******|*******
*********%__$***F---X-------
**************<-J***v*******
^^^^^^#*********************
++++++)*********************
++++++)*********************
++++++)*********************