@---------------------------#
|abab...............qQ....ab|
|cdcd..........o..........cd|
}------!-----------#........|
|....E.|..H........|........|
|......|.......S.<-i>...S...|
|...S..%--->................|
|...........................|
}------------#........ab....|
|ab.....S....|........cd....|
|cd........H.|....^.........|
|.....<------$ab..|.....ab..|
|ab........qQ.cd..|ab...cd/H|
|cdo..G...........vcd.....qQ|
|.G.G///...ab.o.............|
|GqQ./12...cd..........H....|
|G.GG/34.....S....^.......H.|
|0GG.///....ab..<-$ab..abab.|
|.G.H.......cd..qQ/cd..cdcd.|
%---------------------------$